{
	"levels": [
		[
			[ 0,  0,  0,  0,  0,  0,  0,  0,  0],
			[ 0,  1,  1,  1,  1,  1,  1,  1,  0],
			[ 0,  1,  1,  1,  1,  1,  1,  1,  0],
			[ 0,  1,  1,  1,  1,  1,  1,  1,  0],
			[ 0,  1, 90,  1, -1,  1, 91,  1,  0],
			[ 0,  1,  1,  1,  1,  1,  1,  1,  0],
			[ 0,  1,  1,  1,  1,  1,  1,  1,  0],
			[ 0,  1,  1,  1,  1,  1,  1,  1,  0],
			[ 0,  0,  0,  0,  0,  0,  0,  0,  0]
		]
	],
	"options": ["Map Selection", "Exit"],
	"actions": ["load", "quit"],
	"parameters": ["maps/map_selection.json", ""],
	"tag": "menu"
}